%%%%%%%%%%%%%%%%%%%
%.................%
%.................%
%.......P.........%
%.................%
%%%%%%%%%%%%%%%%%%%
